CHI = "countries/CHI.txt"#民国（含南京国民政府、改组派）
ROD = "countries/ROD.txt"#东北军（含伪满、西安绥靖公署）
ROX = "countries/ROX.txt"#新疆
XZS = "countries/XZS.txt"#西藏
ROA = "countries/ROA.txt"#山东
ROS = "countries/ROS.txt"#川系刘湘
ROW = "countries/ROW.txt"#川系刘文辉
ROT = "countries/ROT.txt"#川系田颂尧
RJY = "countries/RJY.txt"
RYS = "countries/RYS.txt"#川系杨森
RHC = "countries/RHC.txt"#川系刘厚存
RDX = "countries/RDX.txt"#川系-邓锡侯
ROG = "countries/ROG.txt"#粤系
ROC = "countries/ROC.txt"#桂系
ROY = "countries/ROY.txt"#滇系
ROQ = "countries/ROQ.txt"#青海马家军
ROK = "countries/ROK.txt"#宁夏马家军
ROZ = "countries/ROZ.txt"#宁夏马家军
PRC = "countries/PRC.txt"#中华苏维埃共和国（含反蒋同盟、中央苏区）
MEG = "countries/MEG.txt"#蒙古
JAP = "countries/JAP.txt"#日本
SOV = "countries/SOV.txt"#苏联
FRA = "countries/FRA.txt"#法国
USA = "countries/USA.txt"#美国
RAJ = "countries/RAJ.txt"#英属印度
SIA = "countries/SIA.txt"#暹罗王国
AFG = "countries/AFG.txt"#阿富汗王国
HOL = "countries/HOL.txt"#荷属印度尼西亚
POR = "countries/POR.txt"#葡属澳门
TAN = "countries/TAN.txt"#图瓦人民共和国
BHU = "countries/BHU.txt"#不丹
NEP = "countries/NEP.txt"#尼泊尔
ROH = "countries/ROH.txt"#黔系-王家烈
SYS = "countries/SYS.txt"#救党护国军/青海西区屯垦军
ROJ = "countries/ROJ.txt"#晋系
MCK = "countries/MCK.txt"#伪满洲国
PCN = "countries/PCN.txt"#公共租界
RFC = "countries/RFC.txt"#中华共和国
CAR = "countries/CAR.txt"#察哈尔民众抗日同盟军
RON = "countries/RON.txt"#湖南军阀
JDW = "countries/JDW.txt"#冀察政务委员会
MGJ = "countries/MGJ.txt"#蒙古军政府
NAF = "countries/NAF.txt"#东北抗日义勇军
JDF = "countries/JDF.txt"#冀东防共自治政府、南京伪国民政府
NHA = "countries/NHA.txt"#鄂豫皖根据地
PRH = "countries/PRH.txt"#湘鄂西根据地
NSD = "countries/NSD.txt"#西北联邦政府、川陕根据地
PRQ = "countries/PRQ.txt"#琼崖根据地
PRJ = "countries/PRJ.txt"#湘赣根据地
NSA = "countries/NSA.txt"#陕甘苏区
YGC = "countries/YGC.txt"#黔系-犹国才
JZZ = "countries/JZZ.txt"#黔系-蒋在珍
SOX = "countries/SOX.txt"#黔系-毛光翔
HZD = "countries/HZD.txt"#黔系-侯之担
YHC = "countries/YHC.txt"#陕系军阀
YUL = "countries/YUL.txt"#榆林军阀
LDC = "countries/LDC.txt"#陇南军阀
BTF = "countries/BTF.txt"#宛西自治
LZN = "countries/LZN.txt"#胶东军阀
DOT = "countries/DOT.txt"#德格土司
TOH = "countries/TOH.txt"#囊谦千户
ZOT = "countries/ZOT.txt"#卓尼土司
SJN = "countries/SJN.txt"#绥军
MBQ = "countries/MBQ.txt"#甘肃马家军
MZY = "countries/MZY.txt"#甘宁青联军
LSX = "countries/LSX.txt"#察东警备军
HET = "countries/HET.txt"#和阗临时政府
PRD = "countries/PRD.txt"#东江根据地
PRY = "countries/PRY.txt"#右江根据地
CEN = "countries/CEN.txt"#中国远征军
NFA = "countries/NFA.txt"#新四军
NAC = "countries/NAC.txt"#华北抗日根据地
NRC = "countries/NRC.txt"#南京安全区
HLJ = "countries/HLJ.txt"#黑龙江自卫军
JLS = "countries/JLS.txt"#吉林自卫军
CGZ = "countries/CGZ.txt"#陈珪璋部队
YWQ = "countries/YWQ.txt"#杨万青部队
MTX = "countries/MTX.txt"#马廷贤部队
YPQ = "countries/YPQ.txt"#察南自治政府（于品卿）
XIA = "countries/XIA.txt"#晋北自治政府（夏恭）
JCJ = "countries/JCJ.txt"#晋察冀根据地
WDL = "countries/WDL.txt"#王德林部队